__----------
-|----------
-|----------
-|----------
-|---------
-|----------
-|----------
-|----------
-|----------
-|----------
-|----------
------------