.__________
|.........|
|.......|.|
|.......|.|
|.......|.|
|.......|.|
|.......|.|
|.......|.|
|.......|.|
|.......|.|
|_________L