.__________
|..___....|
|.|.......|
|.|.......|
|.....|...|
|.....|...|
|.....|...|
|...__....|
|..|......|
|..|......|
|_________L