.__________
|._______||
||.______||
|||._____||
||||.____||
|||||||||||
|||||||||||
|||||L.||||
||||____L||
|||______L|
|L________L
