.__________
|.|.....|.|
|.|.....|.|
|.|.|.|...|
|.|.|_L___L
|.....|...|
|____.|...|
|...|...|.|
|...|___L.|
|.|.......|
|_L_______L