.__________
|..|__._|||
||L.__||L_|
||_L|||.__|
|._||.L|_||
|.L|_|._|||
||..||.||||
|||L|_L||_|
||_||_|_L||
|_L|._...||
|__LL____LL