.__________
|...|.|.|.|
|L.L_L_L_LL
|||..|.___|
|___L_L..||
|.....|.L_L
|_L||||___|
|.___L._|||
|.__|.L.|L|
|...L||.__|
|_____L___L
