.___________
|......____|
|L.L_______L
||.....____|
|_____L..|||
|.....|...||
|_L.|||___||
|.___L._||||
|.__|.L.|L||
|...L.|..|||
|_____L____L
