.__________
|._______||
||._____|||
|||.___||||
||||.__L|||
|||||.|||||
|||||.|||||
|||||L.||||
||||____L||
|||______L|
|L________L