.__________
|.|.|.|_|.L
||||.L|.L||
||_L|L_L._|
||..||._L||
|||||.|.L|L
|._L|L||__|
||___|____|
||._.L.__||
|||.L.|__L|
|L___L____L